NO ./pictures/wall_texture.xpm

WE ./pictures/simple_wall.xpm
EA ./pictures/broken_wall.xpm
SO ./pictures/stone_wall.xpm      

F 144 ,100,2
C 100 ,23,45

1 1
1111111111111
1000000000001
1000000000001
1111111011111
100000000000111
1000000000001001
10000N000000111
1000000000001
1000000000001
1111111111111
